//MAP CONVERTED BY dmm2tgm.py THIS HEADER COMMENT PREVENTS RECONVERSION, DO NOT REMOVE
"a" = (
/turf/simulated/floor/plating/asteroid/basalt/lava_land_surface,
/area/lavaland/surface/outdoors)
"e" = (
/obj/item/chair/wood,
/turf/simulated/floor/plating/asteroid/basalt/lava_land_surface,
/area/lavaland/surface/outdoors)
"R" = (
/obj/structure/chair/noose,
/turf/simulated/floor/plating/asteroid/basalt/lava_land_surface,
/area/lavaland/surface/outdoors)

(1,1,1) = {"
a
a
a
a
a
"}
(2,1,1) = {"
a
a
a
a
a
"}
(3,1,1) = {"
a
a
R
e
a
"}
(4,1,1) = {"
a
a
a
a
a
"}
(5,1,1) = {"
a
a
a
a
a
"}
